0 0 0 0 0 0 0 0 0 0 0 0 0 0 0 0 0 0 0 0 0 0 0 0 0 0 0 0 0 0 0 0 0 0 0 0 0 0 0 0 0 0 0 0 0 0 0 0 0 0
0 55 55 55 55 55 55 55 55 55 50 50 50 51 54 50 50 50 0 61 61 58 58 57 43 42 64 42 65 66 58 58 61 61 0 59 59 59 59 59 59 59 59 59 59 59 59 59 59 0
0 55 55 55 55 55 55 55 55 55 50 50 50 52 53 50 50 50 0 62 61 58 58 57 44 44 44 44 44 66 58 58 61 61 0 60 60 60 60 60 60 60 60 60 60 60 60 60 60 0
0 55 55 55 55 55 55 55 55 55 49 49 49 49 49 49 49 49 0 61 62 58 58 57 44 44 44 44 44 66 58 58 61 61 0 60 60 60 60 60 60 60 60 60 60 60 60 60 60 0
0 55 55 55 55 55 55 55 55 55 45 45 45 45 45 45 45 45 0 62 61 58 58 57 44 44 44 44 44 66 58 58 61 61 0 60 60 60 60 60 60 60 60 60 60 60 60 60 60 0
0 55 55 55 55 55 55 55 55 55 45 45 45 45 45 45 45 45 0 62 61 58 58 57 43 42 64 42 65 66 58 58 61 61 0 60 60 60 60 60 60 60 60 60 60 60 60 60 60 0
0 55 55 55 55 56 55 55 55 55 26 26 26 26 26 26 26 26 0 61 62 58 58 57 43 42 64 42 65 66 58 58 61 61 0 60 60 60 60 60 60 60 60 60 60 60 60 60 60 0
0 45 45 45 45 45 45 45 45 45 45 45 45 45 45 45 45 45 0 61 62 58 58 57 43 42 64 42 65 66 58 58 61 61 0 60 60 60 60 60 60 60 60 60 60 60 60 60 60 0
0 45 45 45 45 45 45 45 45 45 45 45 45 45 45 45 45 45 0 62 61 58 58 57 43 42 64 42 65 66 58 58 61 61 0 60 60 60 60 60 60 60 60 60 60 60 60 60 60 0
0 45 45 45 45 45 45 45 45 45 45 45 45 45 45 45 45 45 0 62 61 58 58 57 43 42 64 42 65 66 58 58 61 61 0 60 60 60 60 60 60 60 60 60 60 60 60 60 60 0
0 45 45 45 45 45 45 45 45 45 45 45 45 45 45 45 45 45 0 62 61 58 58 57 43 42 64 42 65 66 58 58 61 61 0 60 60 60 60 60 60 60 60 60 60 60 60 60 60 0
0 45 45 45 45 45 45 45 45 45 45 45 45 45 45 45 45 45 0 62 62 58 58 57 43 42 64 42 65 66 58 58 61 61 0 60 60 60 60 60 60 60 60 60 60 60 60 60 60 0
0 45 45 45 45 45 45 45 45 45 45 45 45 45 45 45 45 45 0 62 61 58 58 57 43 42 64 42 65 66 58 58 61 61 0 60 60 60 60 60 60 60 60 60 60 60 60 60 60 0
0 45 45 45 45 45 45 45 45 45 45 45 45 45 45 45 45 45 0 61 62 58 58 57 43 42 64 42 65 66 58 58 61 61 0 60 60 60 60 60 60 60 60 60 60 60 60 60 60 0
0 45 45 45 45 45 45 45 45 45 45 45 45 45 45 45 45 45 45 45 45 58 58 57 43 42 64 42 65 66 58 58 60 60 60 60 60 60 60 60 60 60 60 60 60 60 60 60 60 0
0 45 45 45 45 45 45 45 45 45 45 45 45 45 45 45 45 45 45 45 45 58 58 57 43 42 64 42 65 66 58 58 60 60 60 60 60 60 60 60 60 60 60 60 60 60 60 60 60 0
0 45 45 45 45 45 45 45 45 45 45 45 45 45 45 45 45 45 0 61 61 58 58 57 43 42 64 42 65 66 58 58 61 61 0 60 60 60 60 60 60 60 60 60 60 60 60 60 60 0
0 45 46 47 48 45 45 45 46 47 48 45 45 45 46 47 48 45 0 62 61 58 58 57 43 42 64 42 65 66 58 58 61 61 0 60 60 60 60 60 60 60 60 60 60 60 60 60 60 0
0 45 45 45 45 45 45 45 45 45 45 45 45 45 45 45 45 45 0 61 62 58 58 57 43 42 64 42 65 66 58 58 61 61 0 60 60 60 60 60 60 60 60 60 60 60 60 60 60 0
0 45 45 45 45 45 45 45 45 45 45 45 45 45 45 45 45 45 0 61 62 58 58 57 43 42 64 42 65 66 58 58 61 61 0 60 60 60 60 60 60 60 60 60 60 60 60 60 60 0
0 45 46 47 48 45 45 45 46 47 48 45 45 45 46 47 48 45 0 62 61 58 58 57 43 42 64 42 65 66 58 58 61 61 0 60 60 60 60 60 60 60 60 60 60 60 60 60 60 0
0 45 45 45 45 45 45 45 45 45 45 45 45 45 45 45 45 45 0 62 62 58 58 57 43 42 64 42 65 66 58 58 61 61 0 60 60 60 60 60 60 60 60 60 60 60 60 60 60 0
0 45 45 45 45 45 45 45 45 45 45 45 45 45 45 45 45 45 0 61 62 58 58 57 43 42 64 42 65 66 58 58 61 61 0 60 60 60 60 60 60 60 60 60 60 60 60 60 60 0
0 45 45 45 45 45 45 45 45 45 45 45 45 45 45 45 45 45 0 62 61 58 58 57 43 42 64 42 65 66 58 58 61 61 0 60 60 60 60 60 60 60 60 60 60 60 60 60 60 0
0 0 0 0 0 0 0 0 0 0 0 0 0 0 0 0 0 0 0 61 62 58 58 57 43 42 64 42 65 66 58 58 61 61 0 60 60 60 60 60 60 60 60 60 60 60 60 60 60 0
0 0 0 0 0 0 0 0 0 0 0 0 0 0 0 0 0 0 0 61 62 58 58 57 43 42 64 42 65 66 58 58 61 61 0 60 60 60 60 60 60 60 60 60 60 60 60 60 60 0
0 0 0 0 0 0 0 0 0 0 0 0 0 0 0 0 0 0 0 61 62 58 58 57 43 42 64 42 65 66 58 58 61 61 0 60 60 60 60 60 60 60 60 60 60 60 60 60 60 0
0 0 0 0 0 0 0 0 0 0 0 0 0 0 0 0 0 0 0 61 62 58 58 57 44 44 44 44 44 66 58 58 61 61 0 60 60 60 60 60 60 60 60 60 60 60 60 60 60 0
0 0 0 0 0 0 0 0 0 0 0 0 0 0 0 0 0 0 0 61 62 58 58 57 44 44 44 44 44 66 58 58 61 61 0 60 60 60 60 60 60 60 60 60 60 60 60 60 60 0
0 0 0 0 0 0 0 0 0 0 0 0 0 0 0 0 0 0 0 61 62 58 58 57 44 44 44 44 44 66 58 58 61 61 0 60 60 60 60 60 60 60 60 60 60 60 60 60 60 0
0 0 0 0 0 0 0 0 0 0 0 0 0 0 0 0 0 0 0 61 62 58 58 57 43 42 64 42 65 66 58 58 61 61 0 60 60 60 60 60 60 60 60 60 60 60 60 60 60 0
0 0 0 0 0 0 0 0 0 0 0 0 0 0 0 0 0 0 0 0 0 0 0 0 0 0 0 0 0 0 0 0 0 0 0 0 0 0 0 0 0 0 0 0 0 0 0 0 0 0
0 0 0 0 0 0 0 0 0 0 0 0 0 0 0 0 0 0 0 0 0 0 0 0 0 0 0 0 0 0 0 0 0 0 0 0 0 0 0 0 0 0 0 0 0 0 0 0 0 0
0 0 0 0 0 0 0 0 0 0 0 0 0 0 0 0 0 0 0 0 0 0 0 0 0 0 0 0 0 0 0 0 0 0 0 0 0 0 0 0 0 0 0 0 0 0 0 0 0 0
0 0 0 0 0 0 0 0 0 0 0 0 0 0 0 0 0 0 0 0 0 0 0 0 0 0 0 0 0 0 0 0 0 0 0 0 0 0 0 0 0 0 0 0 0 0 0 0 0 0
0 0 0 0 0 0 0 0 0 0 0 0 0 0 0 0 0 0 0 0 0 0 0 0 0 0 0 0 0 0 0 0 0 0 0 0 0 0 0 0 0 0 0 0 0 0 0 0 0 0
0 0 0 0 0 0 0 0 0 0 0 0 0 0 0 0 0 0 0 0 0 0 0 0 0 0 0 0 0 0 0 0 0 0 0 0 0 0 0 0 0 0 0 0 0 0 0 0 0 0
0 0 0 0 0 0 0 0 0 0 0 0 0 0 0 0 0 0 0 0 0 0 0 0 0 0 0 0 0 0 0 0 0 0 0 0 0 0 0 0 0 0 0 0 0 0 0 0 0 0
0 0 0 0 0 0 0 0 0 0 0 0 0 0 0 0 0 0 0 0 0 0 0 0 0 0 0 0 0 0 0 0 0 0 0 0 0 0 0 0 0 0 0 0 0 0 0 0 0 0
0 0 0 0 0 0 0 0 0 0 0 0 0 0 0 0 0 0 0 0 0 0 0 0 0 0 0 0 0 0 0 0 0 0 0 0 0 0 0 0 0 0 0 0 0 0 0 0 0 0
0 0 0 0 0 0 0 0 0 0 0 0 0 0 0 0 0 0 0 0 0 0 0 0 0 0 0 0 0 0 0 0 0 0 0 0 0 0 0 0 0 0 0 0 0 0 0 0 0 0
0 0 0 0 0 0 0 0 0 0 0 0 0 0 0 0 0 0 0 0 0 0 0 0 0 0 0 0 0 0 0 0 0 0 0 0 0 0 0 0 0 0 0 0 0 0 0 0 0 0
0 0 0 0 0 0 0 0 0 0 0 0 0 0 0 0 0 0 0 0 0 0 0 0 0 0 0 0 0 0 0 0 0 0 0 0 0 0 0 0 0 0 0 0 0 0 0 0 0 0
0 0 0 0 0 0 0 0 0 0 0 0 0 0 0 0 0 0 0 0 0 0 0 0 0 0 0 0 0 0 0 0 0 0 0 0 0 0 0 0 0 0 0 0 0 0 0 0 0 0
0 0 0 0 0 0 0 0 0 0 0 0 0 0 0 0 0 0 0 0 0 0 0 0 0 0 0 0 0 0 0 0 0 0 0 0 0 0 0 0 0 0 0 0 0 0 0 0 0 0
0 0 0 0 0 0 0 0 0 0 0 0 0 0 0 0 0 0 0 0 0 0 0 0 0 0 0 0 0 0 0 0 0 0 0 0 0 0 0 0 0 0 0 0 0 0 0 0 0 0
0 0 0 0 0 0 0 0 0 0 0 0 0 0 0 0 0 0 0 0 0 0 0 0 0 0 0 0 0 0 0 0 0 0 0 0 0 0 0 0 0 0 0 0 0 0 0 0 0 0
0 0 0 0 0 0 0 0 0 0 0 0 0 0 0 0 0 0 0 0 0 0 0 0 0 0 0 0 0 0 0 0 0 0 0 0 0 0 0 0 0 0 0 0 0 0 0 0 0 0
0 0 0 0 0 0 0 0 0 0 0 0 0 0 0 0 0 0 0 0 0 0 0 0 0 0 0 0 0 0 0 0 0 0 0 0 0 0 0 0 0 0 0 0 0 0 0 0 0 0
0 0 0 0 0 0 0 0 0 0 0 0 0 0 0 0 0 0 0 0 0 0 0 0 0 0 0 0 0 0 0 0 0 0 0 0 0 0 0 0 0 0 0 0 0 0 0 0 0 0