0 3 3 3 3 3 3 3 3 3 3 3 3 3 3 3 3 3 3 3 3 0 0 0 0 0 0 0 0 0 0 0 0 0 0
0 3 3 3 3 3 3 3 3 3 3 3 3 3 3 3 3 3 3 3 3 0 0 0 0 0 0 0 0 0 0 0 0 0 0
0 3 3 3 3 3 3 3 3 3 3 3 3 3 3 3 3 3 3 3 3 0 0 0 0 0 0 0 0 0 0 0 0 0 0
0 3 4 3 5 3 4 6 7 8 9 10 4 5 3 25 40 25 40 25 40 0 0 0 0 0 0 0 0 0 0 0 0 0 0
0 2 2 2 2 33 31 30 32 31 30 33 32 30 29 24 41 24 41 24 41 0 0 0 0 0 0 0 0 0 0 0 0 0 0
0 11 11 11 11 11 11 11 11 11 11 11 11 11 28 11 11 11 11 11 11 0 0 0 0 0 0 0 0 0 0 0 0 0 0
0 11 11 11 11 11 11 11 11 11 11 11 11 11 28 11 11 11 11 11 11 0 0 0 0 0 0 0 0 0 0 0 0 0 0
0 11 11 11 11 11 11 11 11 11 11 11 11 11 28 11 11 11 11 11 11 0 0 0 0 0 0 0 0 0 0 0 0 0 0
0 11 11 11 11 11 11 11 11 11 11 11 11 11 28 11 11 11 11 11 11 0 0 0 0 0 0 0 0 0 0 0 0 0 0
0 11 11 11 11 26 26 26 26 26 26 26 26 26 27 11 11 11 11 11 11 0 0 0 0 0 0 0 0 0 0 0 0 0 0
0 11 11 11 11 11 11 11 11 11 11 11 11 11 11 11 11 11 11 11 11 0 0 0 0 0 0 0 0 0 0 0 0 0 0
0 11 11 11 11 11 11 11 11 11 11 11 11 11 11 11 11 11 11 11 11 0 0 0 0 0 0 0 0 0 0 0 0 0 0
0 11 11 11 11 11 11 11 11 11 11 11 11 11 11 11 11 11 11 11 11 0 0 0 0 0 0 0 0 0 0 0 0 0 0
0 17 17 34 14 14 14 14 14 14 14 14 14 14 18 11 11 36 14 14 15 20 20 20 20 20 20 23 39 20 20 20 20 20 0
0 17 17 35 12 12 12 13 12 12 12 13 12 12 19 11 11 37 12 13 16 21 21 21 21 21 21 22 38 21 21 21 21 21 0
0 1 1 1 1 1 1 1 1 1 1 1 1 1 1 1 1 1 1 1 1 1 1 1 1 1 1 1 1 1 1 1 1 1 0
0 1 1 1 1 1 1 1 1 1 1 1 1 1 1 1 1 1 1 1 1 1 1 1 1 1 1 1 1 1 1 1 1 1 0
0 1 1 1 1 1 1 1 1 1 1 1 1 1 1 1 1 1 1 1 1 1 1 1 1 1 1 1 1 1 1 1 1 1 0
0 1 1 1 1 1 1 1 1 1 1 1 1 1 1 1 1 1 1 1 1 1 1 1 1 1 1 1 1 1 1 1 1 1 0
0 0 0 0 0 0 0 0 0 0 0 0 0 0 0 0 0 0 0 0 0 0 0 0 0 0 0 0 0 0 0 0 0 0 0